051 047 047 107 047 107 047 047 047 047 047 107 047 047 047 047 107 047 047 107 107 047 047 107 047 047 047 107 047 050
093 000 000 000 000 000 000 000 000 000 000 000 000 000 000 000 000 000 000 000 000 000 000 000 000 000 000 000 000 031
033 000 000 000 000 000 000 000 000 000 000 000 000 000 000 000 000 000 000 000 000 000 000 000 000 000 000 000 000 091
093 000 000 000 000 000 000 000 000 000 000 000 000 000 000 000 000 000 000 000 000 000 000 000 000 000 000 000 000 031
033 000 000 000 000 000 000 000 000 000 000 000 000 000 000 000 000 000 000 000 000 000 000 000 000 000 000 000 000 031
033 000 000 000 000 000 000 000 000 000 000 000 000 000 000 000 000 000 000 000 000 000 000 000 000 000 000 000 000 091
033 000 000 000 000 000 000 000 000 000 000 000 000 000 000 000 000 000 000 000 000 000 000 000 000 000 000 000 000 031
033 000 000 000 000 000 000 000 000 000 000 000 000 000 000 000 000 000 000 000 000 000 000 000 000 000 000 000 000 091
093 000 000 000 000 000 000 000 000 000 000 000 000 000 000 000 000 000 000 000 000 000 000 000 000 000 000 000 000 031
033 000 000 000 000 000 000 000 000 000 000 000 000 000 000 000 000 000 000 000 000 000 000 000 000 000 000 000 000 031
033 000 000 000 000 000 000 000 000 000 000 000 000 000 000 000 000 000 000 000 000 000 000 000 000 000 000 000 000 091
093 000 000 000 000 000 000 000 000 000 000 000 000 000 017 017 017 017 000 000 000 000 000 000 000 000 000 000 000 031
033 000 000 000 000 000 000 000 000 000 000 000 000 000 017 000 000 000 000 000 000 000 000 000 000 000 000 000 000 031
033 000 000 000 000 000 000 000 000 000 000 000 000 000 017 000 000 000 000 000 000 000 000 000 000 000 000 000 000 031
036 017 017 077 017 077 017 017 017 017 017 017 077 017 017 077 017 017 017 077 017 017 077 017 017 017 077 017 017 035