16 00 00 00 00 00 00 00 00 00 00 00 00 00 16
16 00 00 00 00 00 00 00 00 00 00 00 00 00 16
16 00 00 00 00 00 00 00 00 00 17 00 00 00 16
16 00 00 00 00 00 00 00 00 00 00 00 00 00 16
16 00 00 00 00 00 00 00 00 00 00 00 00 00 16
16 00 00 00 00 00 00 00 00 00 00 00 00 00 16
16 00 00 00 00 00 00 00 00 00 00 00 00 00 16
16 00 00 00 00 00 00 00 00 00 16 16 00 00 16
16 00 00 00 00 00 00 00 00 00 00 00 00 00 16
16 00 00 00 00 00 16 16 00 00 00 00 00 00 16