000 000 000 000 000 000 000 000 000 000 000 000 000 000 000 000 000 000 000 000 000 000 000 000 000 000 000 000 000 000 000 000 000
000 000 000 000 000 000 000 000 000 000 000 000 000 000 000 000 000 000 000 000 000 000 000 000 000 000 000 000 000 000 000 000 000
000 000 000 000 000 000 000 000 000 000 000 000 000 000 000 000 000 000 000 000 000 000 000 000 000 000 000 000 000 000 000 000 000
000 000 000 000 000 000 000 000 000 000 000 000 000 000 000 000 000 000 000 000 000 000 000 000 000 000 000 000 000 000 000 000 000
000 000 000 000 000 000 000 000 000 000 000 000 000 000 000 000 000 000 000 000 000 000 000 000 000 000 000 000 000 000 000 000 000
000 000 000 000 000 000 000 000 000 000 000 000 000 000 000 000 000 000 000 000 000 000 000 000 000 000 000 000 000 000 000 000 000
000 000 000 086 000 101 000 115 000 116 000 042 000 000 000 000 000 000 000 000 000 000 000 000 000 000 000 000 000 000 000 000 000
000 000 000 000 000 000 000 000 000 000 025 026 000 000 031 000 000 000 000 000 000 000 000 000 000 000 000 000 000 000 000 000 000
000 000 000 000 000 000 000 000 000 027 040 041 000 000 031 000 000 000 000 000 000 000 000 000 000 000 000 000 000 000 000 000 000
000 115 055 056 102 000 000 000 000 000 000 000 000 000 091 000 000 000 000 000 000 000 000 000 000 000 000 000 000 000 000 000 000
000 000 070 071 000 000 000 000 160 000 145 000 000 000 031 000 000 000 000 000 000 000 000 000 000 000 000 000 000 000 000 000 000
000 000 000 000 000 000 000 020 077 017 017 078 000 000 031 000 000 000 000 000 000 000 000 000 000 000 000 000 000 000 000 000 000
000 000 000 000 000 000 020 081 000 000 000 000 000 000 106 047 047 047 047 107 047 047 047 050 000 000 000 000 000 000 000 000 000
000 000 076 140 017 017 081 000 000 000 000 000 000 000 000 000 087 000 000 000 000 000 000 031 000 000 000 000 000 000 000 000 000
000 000 000 140 000 000 000 000 000 000 000 000 157 000 000 000 000 000 116 025 026 000 000 031 000 000 000 000 000 000 000 000 000
000 000 000 140 000 000 000 000 000 000 000 020 017 017 077 017 017 021 000 040 041 000 000 106 000 000 000 000 000 000 000 000 000
000 000 000 170 000 000 000 000 000 000 020 035 000 000 000 000 000 036 021 000 000 000 000 000 000 000 000 000 000 000 000 000 000
017 017 017 078 142 142 142 142 076 017 035 000 000 000 000 000 000 000 036 021 000 000 000 000 000 000 000 000 000 000 000 000 000
000 000 000 033 000 000 000 000 031 000 000 000 000 000 000 000 000 000 000 036 017 017 017 017 017 000 000 000 000 000 000 000 000
